tropical = {
	1120 1113 2894 1123 1125 2911																			# Gold coast
	1134 2769 1131 2788 1552 2790 1549 2779 1141 1139 2775 5220 3816 1138 2776								# Niger
	4272 1204 4280 																							# Central Africa
	3898 1227 1527 1226 1519 1232	 																		# Madagascar
	5292 573 2336 3157 3156 2570 5296 534 533 5298 532 3151 531 3150 3145 4056 2569 3144 529 3201 			# Subcontinent
	3191 567 3190 2699 3194 3192 568 4219 585 3214 2823 5360 4046 590 4043 3221 579 586 2426 3215 2822 3218	# Burma
	4049 591 3222 3930																						# Siam
	593 3236 592 4216 594 3237 2824 2735 2736 2737 595 599 2828 2830 3315 598 3239 596 3910 597 407 4047 	# Malaysia
	574 420 2103 2102 2101 617 2093 3911 3912 3913 2098 2094 618 3915 3917 2097 3914 3940 2095 2099 3916 	# Sumatra
	619 2096 3918 3920 620 3919 621 623 622 2100 3921 659 													# Sumatra
	3922 624 2108 3923 3924 2107 630 3925 2109 3927 625 4239 2110 3926 4237 626 2106 627 					# Java
	2092 3342 629 2090 2089 640 3341 639 638 3339 738 3340 637 636 3929 2091 651 655 						# Born?o
	657 2217 2216 2215 658 654 2214 656 2213 652 653 2586 													# Philippines
	649 648 2430 2431 645 647 646 1042 716 633 634 4044 2433 641 4042 4045 2432 2589 1238 2590 1239 650		# Moluccas
	642 644 643 3928 1245 2088 714 777 1234 2585 3446 1237 3450 3448 773 3343 3344 1236 2588 1242 1230 3345	# Moluccas
	2587 1235 1233 1231 1246 1241 5234 1097 1243 513 5239 4012 4013 1244 5238 5236 2608						# Moluccas
	3313 2734 3931 2417 2418 3232 3934 611 2419 3233 5225 2396 3229 4214									# Indochina
	3467 3470 756 3476 749 3490 748 3491 1484 742 2074 3493 1483 3494 747 746 1482 3495 745 				# South America
	828 1490 3496 744 743 2076 2079 2077 2080 2087 3405 3406 818 824 1476 1478 825 2081 1480 					# South America
	2084 821 3506 832 1475 826 833 808 2338 2341 814 823 792 1479 835 3492 2752 764 3464 3489				# South America
	803 3443 757 762 761 3466
	3507 836 2209 838 837 1473 2416 3511 2646 3516 1472 842 1709 2602 2599 1710 843 3517	# Central America
	1474 4041 848 3402 												 									# Central America
	487 489 1538 492 1540 1537 1536 502 2593 2594 501 2595 500 499 498 497 496 495 494 2596 493			# Caribbean
	482 484 2591 485 3546 1539 486 483 488 490 491 5240 2592 3597 2206 844 841 2892 1561
	#Atlantis
	5697 5694 5696 5693 5695 5692
}

arid = {
	342 345 346 349 355 359 380 383 384 385 388 389 394 395 396 397 400 401 402 403 404 2235 479 459 
	434 437 438 439 441 443 448 462 465 466 467 468 469 470 471 473 474 5310 430 464 4653 
	512 551 575 576 577 717 718 739 810 865 866 881 882 1098 1115 1116 1147 2943 4096 478 452 
	1148 1158 1160 1162 1167 1208 1210 1211 1212 1324 1331 1332 1339 1466 1500 1516 1524 1526 4058 5311 
	1535 1543 1545 1547 1548 1559 1583 1733 1823 2066 2118 2119 2139 2199 2257 2268 3319 1225 4563 
	2316 2342 2503 2504 2520 2527 2538 2539 2575 3009 3027 3432 2638 1491 2639 2651 2652 1221 
	2657 2658 2659 2660 2661 2665 2715 2718 2719 2740 2741 2745 2746 2747 2771 477 4584 5112 
	2772 2774 2807 2808 2809 2810 2811 1523 2497 2870 2936 2937 2915 2920 2923 2930 2931 2949 4095 
	2938 2939 2999 3068 3069 3070 3071 3073 3074 3075 3076 3077 3099 3100 3121 3210 3274 3282 3306 
	3284 3295 2954 3430 3431 3887 1330 3072 1582 3317 1168 5229 5230 1119 1497 4562 5046 
	3830 3832 2229 3833 3834 3094 3097 3095 3433 3445 3902 4039 4115 4116 5508 2349
	2509 519 2720 3411 804 786 1099 879 2347 2348 2350 390 2544 3888 3028 2649 2165 831 
	2351 3211 3275 2267 3213 2742 3305 2650 4232 2725 3040 1575 3006 1117 
	1571 3015 1202 3043 3024 2792 2951 2952 1574 3320 1215 3318 3035 1149 1224 
	1218 2953 1182 3055 3036 3037 3038 3039 1200 3050 3053 3054 3052 3060 3049 1201 3047 3044 
	3051 3022 5243 2964 1499 1112 2904 2905 348 2916 1118 2959 2922 2918 1563 1081 3312 3296 
	3298 3440 3441 2345 806 809 812 3414 816 862 4122 5160 885 3549 886 2166 5102 
	3287 1083 2258 2260 1319 3089 3900 2230 5242 3026 3062 1203 3048 1161 3439 1487 3449 3447 1488
	5327 3098 3096 2556 2722 2716 3829 435 3831 432 3839 3294 433 4577 440 1340 1585 2499 393 
	3285 4117 3235 5114 5116 5117 5103 5105 5106 5107 2935 3004 2928 3056 5051 5052 5053 5054 5055 
	5056 5057 5058 5059 5060 5061 5062 5063 5064 4091 5164 3058 5048 5050 3742 5104 2972 336 2371 
	4819 4816 4958 2743 4818 1336 978 2273 3704 4609 1309 415 4606 4565 2444 5033
}

arctic = {
	1530 2193 2191 3670 2190 2189 975 3669 3665 909 3663 1010 3661 1002 3666 998 3570 	# North America
	1004 1005 3662 2168 2161 1517 3653 2196 3638 1003 994 996 1000 2481 991 3668 3667 3580 920 1462 3582	# North America
	3629 3630 2180 981 980 3634 890 985 3640 3652 3651 3650 946 3658 3659 1008 3655 1011 2169 3660 1007		# North America
	1001 3656 992																							# North America
	1104 371 370 10 891 1260 1255 2327 3997 19 30 29 31 1261 1262 11 4 								# Scandinavia
	315 35 33 3994 291 314 288 279 278 4203 4208 1072 4209 1529 4206 4205 4204 4202 1075 1078 1074 4630 			# Siberia
	2152 2445 4200 2153 1066 1065 1064 1063 1060 2156 1062 1059 4197 4196 1056 1054 3255 	# Siberia
	1052 2154 4195 1055 1051 2158 2157 4194 2155 3253 721 1044 1040 1039 1038 1037 1035 1036 1034 4023		# Siberia
	2744 1049 3248 2302 2748 4199 1067 1294 2301 1047 3249 3251 3250 4033 1050 1048 																					# Manchuria
	1095 782 783 																							# Magellan Strait
	3209 2259 3208 																				# Eastern China

    4309 4308 1589 4358 4330 1781 2062 4313 1861 1590 2063                                             # Waters (heavy)
    2064 2023 3975 4311 4310 1862 4284 4307 4329                                                            # Waters (medium)
    4328 4285 2061 2060                                                                                # Waters (light)
    5183 2482 5199 5200                                                                           # Wastelands (heavy)
    5185                                                                                                    # Wastelands (medium)
}

mild_winter = {
	3998 23 20 25 2515 6 12 2755 1428 14 67 375 3331 3330 3329 374 3328 2529 373 3335 3334 372 3327 3332 
	3333 376 233 1411 3326 239 247 241 3323 1412 242 1514 3337 249 252 3719 253 1417 3338 369 3396 90 87 
	2353 88 63 2307 167 89 1387 3375 4186 1335 183 2365 192 2241 127 2852 2851 1247 2534 120 2856 2532 
	2531 2562 121 2533 122 2857 2858 3869 2530 118 1379 3702 105 1414 3700 2453 3867 114 1378 217 3864
	113 106 116 2563 3699 117 3698 3868 3697 1380 115 2564 101 1513 102 103 3703 1377 104 3825 2313 216
	1347 1346 3866 2372 1345 109 108 3382 1348 112 107 111 1355 129 2452 130 4034 201 3353 215 198 3354
	3377 1512 2335 202 200 203 976 1323 3373 196 3862 3861 197 212 220 1284 450 208 1409 3350 4070 4621 
	181 213 2368 2369 3368 211 3369 214 2473 1408 2567 210 2514 343 339 2226 5128 5448 5434 2932 1522 2933 
	2934 1515 344 4072 347 4075 2114 2308 1508 1422 2454 3351 3352 207 171 2329 4008 169 2240 168 2330 177 
	1421 2566 2361 2550 1381 175 176 174 3372 357 194 173 2239 172 1388 2234 178 180 195 935 925 900 
	1384 190 2332 191 391 1447 2362 3374 1386 2356 1298 3795 1299 2573 1344 2274 3877 3881 1326 2574 1441 
	184 328 330 1437 3878 323 2553 1446 3388 2552 4067 3387 3386 4066 3389 319 326 2542 4062 878 1821 866 
	324 322 4061 331 329 2540 1443 1440 2551 2227 1314 3078 3079 414 316 3959 2281 3973 2280 2283 3690 
	3954 2796 3958 2282 578 451 4586 446 413 4505 3081 2470 3957 1021 1027 3967 3965 1026 3966 1029 1023 
	1022 3968 1024 3964 1030 1032 3969 1033 2279 3960 3961 4651 438 4551 471 3847 2232 3293 454 3280 4502 
	1143 2510 664 2793 1337 2797 665 685 686 2145 2494 2477 712 3977 3704 3096 4236 3299 5113 2231 4232
	2480 684 1172 3810 3090 3823 417 3824 426 405 3840 3849 2220 2170 687 688 690 2613 2144 691 3657 3827 
	695 2149 2150 2125 2147 693 2493 1089 1046 1068 694 869 1824 3683 3688 938 3609 930 953 952 950 2176 
	904 3610 1451 3611 932 3605 3600 923 3602 924 3590 3589 3562 3561 3560 3559 895 3550 886 882 857 855 
	2641 883 2404 2405 850 2645 2203 2600 2601 899 3564 3563 3588 942 922 3601 3591 3555 3556 3557 3558 
	3005 2502 170 4184 4119 3695 5415 5408 5407 5398 5400 5399 5401 5425 5435 5138 5140 5115 4503 2161 
	5392 5393 5394 5395 5396 5397 5405 5406 5475 5449 5451 5461 5462 5463 5464 5465 5466 5467 5468 4120 
	5505 5417 5416 5101 5074 5079 5045 5123 5118 151 3876 3872 1424 1403 3569 3684 3871 5512 149 2392 1392 
	1396 5142 2855 5198 4955 2607 689 5403 4128 5181 5141 2061 2060 2472 2124 3779 1401 4127 4560 4578 4655
	577 3687 
	#Atlantis
	5648 5609 5608 5607 5598 5610 5611 5613 5612 5614  5615 5604 5602 5601 5600 5707 5706 5607 5619 5661 5663 5662 5653 5655 5651 5698 5652 5699 5650 5639 5637 5638 5633 5632 5632 5636 5635 5639 5627 5631 5630 5629 5635 5700 5703 5551
	5535 5703 5552 5553 5557 5555 5549 5548 5550 5603 5605 5595 5594 5592 5593 5591 5590 5587 5586 5589 5588 5585 5634 5636 5541 5540 5538 5704 5544 5537 5543 5561 5570 5562 5568 5563 5564 5565 5566 5567 5571 5574 5575 5576 5578 5580 5579 5577 5705 5558
	5536 5569 5545 5559 5583 5546 5547 5554 5556 5572 5584 5582 5573 5596 5606 5581 5618 5616 5617 5658
	#
}

normal_winter = {
	18 26 7 24 21 17 16 1256 5 2836 3762 283 3764 3763 2506 271 3759 2816 256 1531 3758 4026 257 1391 1844 
	2355 42 2398 4025 43 2845 48 2849 2834 264 2844 2847 47 2843 3817 72 3821 3820 57 3818 46 3819 1353 45 
	44 1252 3722 3721 13 3754 3720 15 96 2360 2367 92 2363 91 2354 3376 193 4228 2366 2385 204 205 199 418
	68 236 235 1410 234 237 240 427 244 409 3336 248 2512 250 251 1416 246 238 245 3324 3325 243 1283 2386 
	3859 399 2754 2850 258 259 1279 2833 2536 262 3757 2832 263 2400 2815 255 2399 3756 2814 254 2401 2835 
	4003 4002 2561 2633 1359 4001 1278 4000 3999 269 3752 84 265 3751 3750 270 2831 60 266 3749 1277 3748 
	268 267 3747 2384 128 2383 132 134 1510 83 1404 3789 1271 2275 1405 3755 1406 3770 1275 3772 1859 1333 
	1270 1267 1272 1276 3753 1274 2436 3769 153 133 135 2846 152 2390 2391 2612 3773 3775 140 3777 148 
	1591 3780 1427 3776 2382 1426 157 1848 3781 2381 150 159 3782 2380 2376 3787 1398 2377 3785 
	161 3786 3783 3784 2378 3791 2379 1269 160 1400 3794 284 4019 300 1431 285 302 282 286 287 3796 
	1302 4114 303 1303 2656 2578 2579 425 424 3811 2549 1300 3799 3800 3798 1301 423 422 2576 3808 65 
	1317 1449 3801 4027 3804 3807 2577 3809 463 1318 1321 416 3394 3395 3803 3883 3882 2664 3393 3884 1442 
	95 2370 97 98 99 1372 1371 2450 4004 973 100 55 1357 54 53 1352 1364 3724 56 3726 86 2451 93 1444 
	2364 186 1511 94 1362 1363 188 187 189 2812 4006 75 4005 4007 1356 2359 69 74 1349 3378 2616 78 1370 
	3771 1273 2137 3774 141 2389 131 2331 2197 997 62 76 3857 4011 1351 3746 3858 64 3856 1509 2614 2795 
	82 3379 1358 77 80 2615 2622 81 1360 3734 4010 58 1366 3735 3736 974 70 1367 2187 2637 2623 51 1361 
	4009 1253 1368 85 156 2449 2756 3732 1365 3733 3812 3731 2757 79 3730 1369 3725 3813 61 3729 3727 3728 
	2618 49 3822 71 3380 2813 3741 3737 3814 3855 2619 3740 3852 3851 2617 3850 1373 1350 3738 52 66 2621 
	3745 4015 50 2620 3743 59 2299 2300 1025 1019 3739 3853 3854 3815 2284 3953 3952 2285 1316 4660 
	2286 2290 2291 3947 2295 3944 2298 3943 3945 2296 2297 2277 2293 3950 3949 3948 3946 2292 2294 2287 
	3956 2288 3955 3951 2289 3974 2435 3962 1031 1028 3963 2605 2252 2256 2255 2162 2257 2119 4365 
	2254 718 2804 736 2805 2233 2803 1006 2159 3654 3723 3744 2334 5156 3276 4030 5111 4652 
	735 2806 734 2802 733 2801 730 2249 4035 4036 4037 3241 4031 731 3258 2266 4038 2248 707 713 412 
	3240 706 2265 3263 708 3842 449 2745 2741 2746 2118 3210 3211 739 737 4028 4029 1445 2219 2559 3080 
	704 705 724 703 2491 2560 698 2148 696 699 2492 697 1041 2485 701 702 2471 2467 2246 700 462 443 439 
	2476 2468 2251 2743 3213 2742 478 2273  460 459 3302 3305 3306 3303 461 477 2223 3311 453 4595 4602 
	3296 2221 3298 3301 476 3292 458 3291 2269 4188 2747 972 3286 4597 5072 3285 978 4745 4506 4958 
	870 872 3679 2184 3678 876 3676 3677 2185 2167 3685 3603 3604 3612 3613 3614 2178 4816 4819 4613 5022 
	936 954 916 961 962 1452 963 2177 939 965 966 980 981 982 984 3632 3633 983 2182 1458 2179 2740 
	971 970 968 3691 3628 969 964 3627 3623 3626 959 955 1459 960 1454 3587 3586 951 3585 949 934 3565 
	918 898 3566 903 3568 1460 3575 902 3576 2172 915 914 937 3581 3675 3631 967 901 1494 917 3577 941 
	1493 943 944 958 3584 3583 3618 2785 956 3617 3615 3616 3621 3622 3620 3619 3624 3625 957 920 945 3647 
	3646 179 3371 1385 1375 3567 3681 3680 3682 894 5452 5477 5495 5454 386 3300 4588 4535 3705 4528 5110  
	5371 5372 5373 5374 5375 5376 5377 5379 5380 5381 5382 5383 5384 5385 5386 5387 5388 5389 5390 5391 5402
	5404 5470 5469 5472 5479 5480 5481 5482 5483 5484 5487 5488 5489 5490 5491 5493 5494 5378 5492 5471 
	5478 5474 5473 5476	1009 995 3639 999 1822 732 2461 889 877 977 3863 5137 5139 5135 1315 419 4806  
	5133 5120 5119 5501 3275 3879 5121 5170 5167 5172 5202 5173 5174 5122 5132 5250 3880 4608 3370 4328 
    2023 4329 4311 4310 1862 4284 4307 4960 4983 4230 5153 4126 5161 5149 5146 3701 5129 4818 717 1336 4959                                                           # Waters (medium)
    3274 5075 5076 5077 5078 5080 4504 4561 5143 4088 5145 5147 5144 1450 2537 4605 5514 4507 660 4981 867  
	722 2267 2247 3268 709 2253 2268 4039 4941 5217 5506 5450 5169 5127 5206 3282 5486 5098 2541 5453 4533 3662
	4231 1420 209 1767 5513 119 1383 1382 3860 1376 1390 2611 2624 3381 1858 4942 4615 4076 5205 4949 4950 # Wastelands (medium)
	#Atlantis
	5643 5642 5640 5641 5644 5645 5646 5647
}

severe_winter = {
	1 2 3 9 27 28 32 4 8 10 11 19 22 29 30 31 33 34 35 36 37 38 39 40 73 110 165 166 185 277 278 279 281 
	288 289 290 291 292 293 294 295 297 298 299 301 304 305 306 307 308 309 310 311 312 313 314 315 370 
	371 381 508 509 523 554 557 562 565 740 782 783 784 873 874 891 906 908 909 910 911 912 913 926 719
	946 947 948 975 987 988 985 890 989 990 991 992 993 994 996 998 905 272 274 273 275 276 728 261 
	260 158 162 296 479 472 475 41 721 729 727 280 666 986 940 720 726 725 723 715 
	1000 1001 1002 1003 1004 1005 1007 1008 1010 1011 1035 1036 1037 1038 1039 1040 1044 1045 1047 1051 
	1052 1054 1055 1057 1059 1060 1062 1063 1064 1065 1066 1067 1069 1070 1071 1072 1074 1075 1077 1078 
	1079 1080 1082 1104 1194 1217 1250 1251 1254 1255 1260 1261 1262 1266 1286 1288 1289 1290 1291 1292 
	1294 1295 1296 1305 1306 1307 1308 1310 1311 1343 1374 1389 1448 1489 1517 1529 1530 1865 2115 4596 
	2116 2120 2122 2143 2152 2153 2154 2155 2156 2157 2158 2160 2168 2169 2171 2186 2188 2189 2190 
	2191 2193 2196 2198 2259 2261 2262 2263 2264 2327 2437 3975 2438 2439 2440 2441 2442 2443 2444 2445 
	2446 2546 2547 2548 2580 2582 2583 2625 2691 2692 2700 2701 2748 2333 2447 2455 2456 2457 2458 3846 
	2466 2469 2474 2475 2479 2481 2840 2841 3105 3107 3110 2064 3112 3113 3193 3197 3198 3205 3206 3207 
	3208 3322 2195 3670 3669 3668 3673 3674 3667 3666 3665 1765 3664 3570 3571 3572 3573 3574 3580 3579 
	3578 3663 3661 3660 3659 3658 3653 3655 3656 1462 3582 3643 3648 3650 3651 3649 3645 3644 3641 
	3640 3638 3637 3981 3982 3983 2671 3629 4418 3984 3985 3986 3987 3988 3989 3990 3991 3992 3993 
	3994 3997 4016 4017 4023 4022 4111 4112 3212 4100 4102 4189 4190 4191 4192 4193 4194 4195 4196 4197 
	4198 4199 4200 4201 4202 4203 4204 4205 4206 4207 4208 4209 1259 1258 1257 3401 3400 3767 3768 1354 
	3766 1263 3399 1430 3765 3980 1264 1432 1265 1280 1394 3398 3397 2842 1393 2848 2839 2837 1395 2838 
	1433 2626 3793 2236 3792 3788 3790 1282 2507 2535 1281 3760 3761 1429 3802 2581 3805 3806 
	1293 4113 3287 1083 3310 1081 1073 2375 1309 1304 1297 4020 1287 2545 4110 4018 3312 3304 4557 5046 
	3309 3277 3308 1076 1312 4024 1034 2302 2301 2744 2328 3245 3248 1049 3249 4032 3247 1050 3250 4594 
	2270 2271 3272 1061 3271 3270 1056 3269 3257 3261 1058 3254 3253 4033 3255 3251 1048 3252 3246 3244 
	3243 2463 3209 2260 2258 4124 4125 3848 1465 1464 3642 2180 3636 3635 2183 3634 3630 3686 4603 4523 
	2800 2798 4240 3283 3845 5485 3256 3260 3265 3264 3266 3267 3273 3262 5131 5073 4956 4957 
	3259 4054 4099 2799 5155 4536 2465 5033 4548 4964 4965 4966 4967 4968 4516 5036 4593 
	5037 5038 5039 4518 4600 4705 4522 5245 5034 5035 5040 5041 5042 5043 5044 4517 4592 5209 5002 5003 
	5210 5204 4521 4529 4599 5502 4545 4531 4946 4953 4519 4530 4550 4564 4674 4944 4943 4021 3797 
	365 5148 5197 4628 5152 5194 4627 5196 5151 4626 5150 5195 5193 4625 5171 5165 5166 5517 5291 
    4309 4308 1589 4358 4330 1781 2062 4313 1861 1590 2063 1850 5177 4101 5162 4624 4077 5163 4103 5503 
	4558 4509 4508 4233 4630 4537 4549 4579 4552 5168 1268 139 1397 4185 5182 5004 5203 4961 3242 4543 
	4963 4969 4962 4970 4952 4951 5186 4971 4976 4977 4978 4979 4980 3652 4975 4974 4973 4972 5185 3672 
	# Waters (heavy)
    2482 5199 5200 5201 4187 5176 5284 1972 1756 4104 																# Wastelands (heavy)
}

impassable = {
	365 406 740 438 443 718 785 786 277 980 992 
	1152 2143 2333 2447 2455 2456 2457 2458 2459 2460 2466 2474 2479 2482 2483 2487 2489 2495 2505 2508 
	2509 2511 2513 2517 2697 2747 2761 2798 2799 2901 3212 3545 3705 3706 3835 3837 3880 3941 4022 3274 
	3295 4051 4052 4053 4076 4077 4081 4082 4083 4084 4085 4086 4087 5184 4088 4089 4090 4099 4100 4101 
	4102 4103 4118 4120 4121 3321 4123 2791 1197 1179 4126 4127 4128 3282 1045 4184 4185 4187 4188 4189 
	4190 4191 4192 4193 4207 4210 4220 4221 4222 4223 4224 4225 4226 4227 4229 4230 4231 1312 1324 4233 
	3121 4235 4236 4238 4240 4281 2667 3846 3027 2954 2502 2222 2441 2223 3283 3845 5226 5241 2469 1590 
	1781 1861 2525 2609 2610 5291 2160 2475 5507 3673 2269 5246 5247 5248 5249 5250 5350 5351 5359 5361 
	5362 5363 5364 5365 5366 5367 5368 5369 1837 2008 5370 5452 5453 5454 5477 5485 5486 5495 5496 5502 
	5503 1972 4104 5284 5232 5233 5224 5110 5115 5127 5128 5129 5130 5141 5144 5145 5146 5147 5148 5149 
	5150 5151 5152 5153 5155 5157 5158 5159 5161 5162 5163 5165 5166 5167 5168 5169 5170 5171 5172 5173 
	5174 5175 5176 5177 5178 5179 5180 5181 5182 5183 5185 5186 5187 5188 5189 5190 5191 5192 5193 
	5194 5195 5196 5197 5198 5199 5200 5201 5202 5203 5204 5205 5206 5207 5208 5209 5210 5211 5212 5213 
	5214 5215 5216 5217 5109 4945 4946 5094 5095 5096 5097 5098 5099 5100 2908 3889 5071 5072 5047 5512 
	5513 5514 3648 4621 4622 4567 4628 4982 4987 4988 4989 4990 4992 4993 4994 4995 4996 4997 4998 4999 
	5000 3641 3645 4625 4626 4627 5001 5002 5003 5004 5005 5006 5007 5008 5009 5010 5011 5012 5013 5014 
	5015 5016 5017 5018 5019 5020 5021 5022 5023 5024 5025 5026 5027 5028 5029 5030 5031 5032 5034 5035 
	5036 5037 5038 5039 5040 5041 5042 5043 5044 4948 4949 4950 4951 4952 4953 4954 4959 4961 4962 4963 
	5183 4969 4970 4971 4972 4973 4974 4975 4976 4977 4978 4979 4980 4981 1000 1003 1007 1008 1010 2196 
	3653 3656 3663 1001 3672 3660 2191 3661 4947 4515 4556 4566 4568 4569 4570 4572 4580 4589 4590 4512 
	4514 4555 4604 4511 4610 4624 4536 4588 4507 4558 4509 4508 4605 4504 4554 4501 4505 4502 4503 4586 
	4560 4547 4534 4583 4552 4561 4535 4527 4573 4525 4526 4608 4575 4601 4574 4576 4551 4602 4579 4528 
	4529 4533 4517 4518 4557 4530 4545 4519 4550 4523 4603 4537 4600 4522 4506 4522 4548 4564 4516 4521 
	4613 4745 4543 4593 4592 4531 4674 4549 4578 5517 
	#Atlantis
	5518 5519 5597
}

mild_monsoon = {
	#Far East
	5429 5428 5424 5426 712 5425 693 5417 2493 691 695 5408 5415 3977 2147 2125 2607 5395 5394 5393 5398 1068 694 
	5401 5400 5399 1046 5416 1822 1021 1020 1017 1018 2278 3970 1027 3967 1026 3966 1029 1030 3964 1032 2295 3944 
	3943 2298 3945 2296 2297 
	#Indochina
	608 3933 609 3226 3930 4215 2820 2668 603 2306 600 602 2421 2821 3909 2670 2321 601 2422 3908 586 2426 3215 
	2822 3216 2425 2428 580 569 3903 3217 2429 584 3906 588 587 3905 2427 3904 352 2728 2727 2324 4218 3219 2322 
	3220 
	#Indonesia
	1094 2134 2213 652 617 3912 2093 3911 
	#India
	2337 572 2336 3124 2710 3199 2713 2712 3238 536 3158 538 5294 537 2673 5300 539 1520 5297 5295 2674 2629 2245 
	542 3159 4078 5301 541 2672 2628 507 3160 546 3162 5306 3163 5307 5308 3166 3168 3143 527 3146 2243 3164 3165 
	2681 518 2707 526 3117 2706 3120 3115 521 3114 3111 5329 3106 564 510 5328 3109 2113 3102 5299 2676 2675 3154 
	540 5302 4079 3153 3155 547 2677 544 543 2678 1587 530 2212 5303 545 3161 
	#Africa
	3895 3896 4245 2991 1192 1492 1193 1189 1507 1578 4246 4248 5223 2981 2879 2975 1155 2974 5219 1157 2979 2980 
	1159 1156 4267 1153 4264 4263 4262 4261 4258 4259 4260 4265 4266 4253 4250 4274 4273 2218 2194 2871 1114 1221 
	1563 2946 1133 1560 2950 2948 2926 2927 2925 1137 1122 1553 1554 5108 2895 2794 2780 2960 2961 2963 1129 2781 
	1105 2902 1495 2958 2914 2957 2910 2766 1525 1124 1121 2899 2765 1542 2770 2893 5091 5093 5085 5086 5087 
	#South America
	751 3489 749 3490 750 2071 3460 3461 3459 769 766 3464 764 3463 3462 763 3465 3468 770 768 3456 
}

normal_monsoon = {
	#Far East
	671 2073 2117 710 675 673 674 3939 2464 711 5441 677 676 5440 2121 678 5437 5436 2486 679 2488 5420 1053 5418 
	5419 5421 680 2606 5422 5423 2484 2490 5410 5411 2142 692 2141 5409 5412 5414 5413 2272 2145 2494 1089 2304 
	2305 2303 1012 1013 1014 1015 1016 3972 2276 877 737 2804 889 2461 736 2805 2806 734 2803 2233 735 2802 733 
	2801 1023 1022 3968 1024 3969 3965 1028 3963 3962 1031 3961 2279 3960 2281 3973 2280 3959 2283 1033 3954 
	2796 3958 2282 3957 3947 2291 2285 3952 3953 2284 2435 3956 2288 3974 2290 2289 3955 3951 2277 3950 3949 3948 
	2293 3946 2292 2294 2287 2286 
	#Indochina
	2819 3227 3313 2734 3228 604 3931 3932 2417 2827 605 606 4214 2317 3229 607 2318 2397 3230 2418 2419 2396 610 
	4211 2731 3937 2325 3314 616 2395 3936 613 3938 2393 2394 
	#Indonesia
	595 2830 3239 596 3913 2098 2094 2097 3917 618 3914 3940 3915 2099 2095 3916 620 4047 2108 3924 630 2109 
	628 626 2105 2106 2104 627 631 632 633 907 635 1642 716 1042 646 645 2430 2431 648 649 2586 3928 643 2432 2585 
	638 3339 655 653 656 2214 2215 658 2216 2217 657 644 1237 3344 3343 773 1236 2588 2136 799 3448 3450 
	#India
	421 515 516 520 522 524 528 533 534 550 553 555 558 559 560 573 582 1248 2163 2210 2211 2244 2555 2557 
	2558 2570 2627 2630 2632 2679 2680 2684 2688 2689 2690 2702 2703 2704 2705 2708 2709 2711 2714 2723 2739 3116 
	3118 3119 3125 3126 3127 3128 3129 3130 3131 3132 3133 3134 3135 3136 3137 3138 3139 3140 3141 3142 3147 3148 
	3149 3156 3157 3167 3174 3175 3176 3178 3179 3180 3181 3182 3195 3196 3197 3201 3202 3204 5292 5293 5296 5298 
	5304 5305 5309 5316 5317 5318 5319 5320 5323 5324 5325 5330 5331 5332 5333 5334 5335 5336 5337 5338 5339 5340 
	5341 5342 5343 5344 5345 5352 5353 
	#Africa
	979 1100 1101 1102 1103 1110 1125 1126 1127 1128 1140 1142 1144 1145 1146 1151 1154 1177 1180 1181 1184 1185 
	1186 1187 1188 1190 1191 1196 1204 1228 1229 1496 1502 1503 1504 1505 1518 1528 1550 1551 1556 1557 1558 
	1561 1562 1564 2758 2759 2760 2762 2767 2775 2778 2785 2787 2789 2874 2875 2876 2877 2878 2880 2883 2884 2886 
	2887 2888 2890 2891 2892 2897 2898 2900 2911 2912 2973 2976 2977 2978 2982 2983 2984 2985 2986 2987 2988 2994 
	3671 3893 3894 3899 3942 4243 4244 4247 4249 4251 4252 4254 4255 4257 4269 4270 4271 4275 4276 4277 4278 4279 
	4280 4281 4282 4283 5136 5218 2872 2773 1527 5092 5088 5089 5090 5049 
	#South America
	1483 3492 742 2076 1484 3491 748 2752 2079 2081 2075 762 761 3466 3467 757 767 765 3457 
	#Polynesia
	2527 4014 506 4013 1097 513 1243 2608 1244 5235 5236 5237 1108 1107 1106 822 1249 1109 1240 2151 1341 4012 5238 
	5239 1242 650 1239 2590 1238 1241 1246 1232 2012 2587 1235 1230 654 4081 535
}

severe_monsoon = {
	#Indochina
	4219 585 3214 579 5360 2823 4046 3218 590 4043 2825 3223 3221 2420 4050 4049 591 3222 593 2738 3236 592 4216 594 
	3237 2736 2737 2824 2735 599 2828 3315 598 3910 597 4048 
	#Indonesia
	2101 2102 2103 619 2096 3918 3919 621 623 622 2100 3920 3921 659 624 3922 3923 2107 3925 625 3927 2110 4239 3926 
	4237 2111 647 2434 4044 2433 4045 642 4042 641 639 3341 640 2089 2090 629 3342 2092 2091 3929 636 637 738 3340 
	3446 777 1234 714 2088 1245 3345 2513 2511 2697 
	#India
	517 2568 529 3144 2569 4056 3145 3150 531 3151 3152 532 2682 552 5322 3200 3177 5321 548 2683 3172 3173 549 556 
	2687 2686 3171 2554 3170 3169 2685 5244 561 5249 563 3190 568 3192 3194 2699 567 2698 570 571 566 2695 3186 
	2694 5354 3185 3184 2693 5346 5326 1588 5347 5348 5357 2696 5358 3191 3189 5356 3203 5355 3187 3188 3183
	5349 
	#Africa
	3897 3898 1227 1519 1521 5220 1141 1139 2779 3816 1138 1549 2776 1552 2790 2788 1131 2769 1134 2786 2889 2885 
	1111 1123 2894 2873 2768 1113 1120 2966 2906 2192 
}

equator_y_on_province_image = 947
